###############
#.............#
#.###.###.###.#
#.#...#...#.#.#
#.#.###.###.#.#
#.....#.#.....#
###.###$###.###
#.....#.#.....#
#.#.###.###.#.#
#.#...#...#.#.#
#.###.###.###.#
#.............#
###############
